%%%%
%. %
% .%
%.%%
%..%
%%.%
%.P%
%%%%
