%%%%
%. %
% P%
%.%%
%  %
% .%
%. %
%%%%
