%%%%
%..%
%P.%
% %%
%..%
%..%
% .%
%%%%
