%%%%%
% ..%
% P.%
%.%.%
%.%.%
%%  %
% . %
%  %%
%%%%%