%%%%%
%  .%
%  .%
%.%.%
%.  %
%%  %
%   %
%.P%%
%%%%%