%%%%%
%P .%
%%% %
%.%.%
%...%
%   %
% . %
%  %%
%%%%%