%%%%%%
%.%..%
%P...%
%.%%%%
%   .%
%.%. %
%. %.%
%..%.%
%%...%
%%%%%%
