%%%%%%
%.% .%
%   .%
%.%%%%
% %%%%
%.%.P%
%. %.%
%    %
%%...%
%%%%%%
