%%%%%%
%.%..%
%   .%
%.%%%%
%    %
%    %
%. %.%
%   P%
%% ..%
%%%%%%
