%%%%%%%
%  ...%
%. %. %
%.    %
% %  .%
%  %..%
%    .%
%P    %
%   ..%
%%.%..%
%%%%%%%