%%%%%%%
%%P...%
%. %%%%
%     %
% %  .%
% %.. %
% %  .%
% %%%%%
%    .%
%%.% .%
%%%%%%%