%%%%%%%
%  P  %
%%%%. %
% ..  %
% %%% %
%  %..%
%   % %
%.....%
%%% ..%
%%%%..%
%%%%%%%