%%%%%%%%
%  .   %
%.%%% %%
%.%%% %%
% % .  %
% P   .%
% .%  .%
%.    .%
%    . %
%.  ...%
%%%%%%%%