%%%%%%%%
%  .  P%
%.%%% %%
%.%%% %%
% % . %%
% %   .%
% .%  .%
%.%%%%%%
% ..  %%
% . .  %
%%%%%%%%