%%%%%%%%%
%  ..   %
%.%   ..%
%.      %
% % %%%%%
% P   . %
% .   %.%
% . %  %%
% %.   .%
%       %
%      .%
%%%%%%%%%