%%%%%%%%%
%  .....%
%.%     %
%.     P%
% % %%%%%
% %   . %
% %   %.%
% %   % %
% %.   .%
%  %.   %
%. %%%%.%
%%%%%%%%%