%%%%%%%%%
%  . . .%
%.%   ..%
%. P    %
%       %
%     . %
% . %.%.%
% . %  %%
% %%%%%%%
%  . . .%
%      .%
%%%%%%%%%