%%%%%%%%%%
%  .     %
%.%    ..%
% . %   %%
% %.    .%
%.       %
%  %%%% %%
% P  % %%%
%        %
%       %%
%%%.    .%
%   %.   %
%   .. ..%
%%%%%%%%%%