%%%%%%%%%%
%  .    P%
%.%%%%  .%
% . %   %%
%%%%% %%%%
%.       %
% % %%% %%
%        %
% .   %  %
%      .%%
% %.    .%
%   %.   %
%..%   . %
%%%%%%%%%%