%%%%%%%%%%
%        %
%.%%%%% .%
%P .    .%
%...     %
%        %
%%%%%%   %
% .    . %
%...     %
%        %
%%%%%%   %
%  .    .%
%...     %
%%%%%%%%%%